al_marine	antigonish	marine
bea_lake	bear_paw_lake	lake
boot_lake	boot	lake
boot_stream	boot	stream
cl_marine	lunenburg	marine
cl_white	lunenburg	white
constance_lake	constance	lake
constance_stream	constance	stream
cp_marine	antigonish	marine
cr_stream	crooked_river	stream
cs_marine	oregon_coast_mid	marine
denmark_marine	denmark	marine
geneva_lake	geneva	lake
geneva_stream	geneva	stream
hadsten_lake	hadsten	lake
japan_marine	japan_pacific	marine
japan_japansea	japan_sea	japansea
joes_lake	joes	lake
joes_stream	joes	stream
hald_lake	lake_hald	lake
litcampbell_marine	lit_campbell	marine
ln_marine	brasdor	marine
lq_benthic	little_quarry	benthic
lq_limnetic	little_quarry	limnetic
mariager_marine	mariager	marine
mh_marine	chedabucto	marine
mh_white	chedabucto	white
misty_lake	misty	lake
misty_stream	misty	stream
ms_marine	oregon_coast_north	marine
mud_lake	mud_lake	lake
pax_benthic	paxton	benthic
pax_limnetic	paxton	limnetic
pcr_lake	pony_creek	lake
pl_lake	paulina_lake	lake
pri_benthic	priest	benthic
pri_limnetic	priest	limnetic
rab_marine	rabbit_slough	marine
rb_stream	riverbend	stream
res_marine	resurrection_bay	marine
roberts_lake	roberts	lake
roberts_stream	roberts	stream
sj_marine	oregon_coast_mid	marine
sk_marine	brasdor	marine
sr_marine	chedabucto	marine
sr_white	chedabucto	white
stl_lake	south_twin_lake	lake
wc_stream	winchester	stream
